111111111111111111
10000P001111111111
111111100111111111
10C000C00000000111
10000000000000E011
111111111111111110