111111111
1P1000001
111C000E1
111111111