111111111111111111111
1000000000PP000000001
100000E00000000000111
11110000000C000C00001
111111111111111111111