11111111111
10101010101
100000P0011
11111111011
1C10000E001
11111111111