1111111111111
10010000000C1
1000011110011
11P011100E001
1111111111111